XXXXXXXXXXXXXXXXXXXXXXXXXXXXXXXXXXXXXXXX
X          EX X X X X                  X
X XXXXXXXXXXX       XX XXXXXXXXXXXXXXX X
X XX XX X     X XXX  XXX X           X X
X X       XXX X X XX       XXX XXX X X X
X X XXXXXXXXX X   XX XXXXXXX X X XXXXX X
X X X       X XXXXX      X X X X     X X
X X X XXXXXXX     X XX X X     XXXXX X X
X X X   XX XXXXXXXX  X X X X X X     X X
X X XXX X   X     X XX X XXXXXXXX XX X X
X X X   X X X XXX X X  X       X   XXX X
X X X XXX X X X   X XXXX XXXXX X X   X X
X X X   X X X X XXX X    X   X XXX X X X
X X XXX X X X X X   XXXX X X X     X X X
X X     X X   X   X XS   X X X XXXXXXX X
X XXXXXXX XXXXXXXXXXXXXXXX X X X     X X
X X         X X XX X X X   X X XX X XX X
X X XXXXXXXXX X X      X XXX X  XXX    X
X X X           X XXXX XXX   XX     XX X
X X XX XXXXXXXX X X  X     XXX  XXXXXX X
X X X      X    X XX X X XXX   XXX X X X
X X XXXXXX XXXXXX  X XXXXX   X X     X X
X X X    X X XX XX X       XXX X XX XX X
X X X XX X       X XXXXXXXXXXX XXXX  X X
X X X  X XXXX XX X           X      XX X
X X XXXX X XXXXX XXXXXXXXXXX XXXXXX XX X
X X      X                           X X
X XXXXXXXXXXXXXXXXXXXXXXXXXXXXXXXXXXXX X
X                                      X
XXXXXXXXXXXXXXXXXXXXXXXXXXXXXXXXXXXXXXXX
